9,5
6 6 6 6 6 6 6 6 6 6 6 6 6 6 6 6
6 2 2 2 6 2 2 2 6 2 2 2 2 2 2 6
6 2 2 2 6 2 2 2 6 2 2 2 2 2 2 6
6 2 2 2 6 2 2 2 6 2 2 2 2 2 2 6
2 2 2 2 6 2 2 2 2 2 2 2 6 12 12 2
2 2 2 2 6 2 2 2 2 2 2 2 6 2 2 2
2 2 2 2 6 2 2 2 2 2 2 2 6 2 2 2
6 2 2 2 12 2 2 2 6 2 2 2 6 2 2 6
6 2 2 2 12 2 2 2 6 2 2 2 6 2 2 6
6 2 2 2 12 2 2 2 6 2 2 2 6 2 2 6
6 6 6 6 6 6 6 6 6 6 6 6 6 6 6 6