6,5
8 8 8 8 8 8 8 8 8 8 8 8 8 8 8 8
8 0 0 10 0 0 0 0 0 0 0 0 0 0 0 8
8 0 0 10 0 0 0 0 0 0 0 0 0 0 0 8
8 0 0 3 3 0 0 0 0 0 0 3 3 0 0 8
0 0 0 3 0 0 0 0 0 0 0 0 3 0 0 0
0 0 0 3 0 0 0 0 0 0 0 0 3 0 0 0
0 0 0 3 0 0 0 0 0 0 0 0 3 0 0 0
8 0 0 3 3 0 0 0 0 0 0 3 3 0 0 8
8 0 0 0 0 0 0 0 0 0 0 0 10 0 0 8
8 0 0 0 0 0 0 0 0 0 0 0 10 0 0 8
8 8 8 8 8 8 8 8 8 8 8 8 8 8 8 8