10,5
9 9 9 9 9 9 9 9 9 9 9 9 9 9 9 9
9 1 1 1 1 1 1 11 11 1 1 1 1 1 1 9
9 1 1 1 1 1 1 11 11 1 1 1 1 1 1 9
9 1 1 1 1 1 9 9 9 9 1 1 1 1 1 9
1 1 1 1 1 1 9 9 9 9 1 1 1 1 1 1
1 1 1 1 1 1 9 9 9 9 1 1 1 1 1 1
1 1 1 1 1 1 9 9 9 9 1 1 1 1 1 1
9 1 1 1 1 1 9 9 9 9 1 1 1 1 1 9
9 1 1 1 1 1 1 11 11 1 1 1 1 1 1 9
9 1 1 1 1 1 1 11 11 1 1 1 1 1 1 9
9 9 9 9 9 9 9 9 9 9 9 9 9 9 9 9