10,5
7 7 7 7 7 7 7 7 7 7 7 7 7 7 7 7
7 2 2 2 2 12 12 2 2 2 2 2 2 2 2 7
7 2 2 2 2 12 12 2 2 2 2 2 2 2 2 7
7 2 2 2 2 6 6 2 2 2 2 2 2 2 2 7
2 2 2 2 2 6 6 2 2 2 2 2 2 2 2 2
2 2 2 6 6 6 6 6 6 2 2 2 2 2 2 2
2 2 2 2 2 6 6 2 2 2 2 2 2 2 2 2
7 2 2 2 2 6 6 2 2 2 2 2 2 2 2 7
7 2 2 2 2 12 12 2 2 2 2 2 2 2 2 7
7 2 2 2 2 12 12 2 2 2 2 2 2 2 2 7
7 7 7 7 7 7 7 7 7 7 7 7 7 7 7 7